# Este es un archivo de ejemplo. 
6, 8

# Jugador 
1,4,1,0,0,0,0 

# Paredes 
0,3,4,0,0,0,0 
0,4,4,0,0,0,0
0,5,4,0,0,0,0 
0,6,4,0,0,0,0 
0,7,4,0,0,0,0 
1,0,4,0,0,0,0 
1,1,4,0,0,0,0 
1,2,4,0,0,0,0 
1,3,4,0,0,0,0 
1,7,4,0,0,0,0 
2,0,4,0,0,0,0 
2,7,4,0,0,0,0 
3,0,4,0,0,0,0 
3,6,4,0,0,0,0 
3,7,4,0,0,0,0 
4,0,4,0,0,0,0 
4,3,4,0,0,0,0 
4,4,4,0,0,0,0 
4,5,4,0,0,0,0 
4,6,4,0,0,0,0 
4,7,4,0,0,0,0 
5,0,4,0,0,0,0 
5,1,4,0,0,0,0 
5,2,4,0,0,0,0 
5,3,4,0,0,0,0 

# Cajas 
2, 3, 2, 0, 0, 0, 255 
2, 4, 2, 0, 0, 0, 255 

# Celdas destino 
2,4,3,0,0,0,255 # Celda destino de la caja amarilla 
2,5,3,0,0,0,255  # Celda destino de la caja verde 